SO ./textures/so.xpm
NO ./textures/no.xpm
WE ./textures/we.xpm
EA ./textures/ea.xpm

F 220,100,0
C 225,30,0

111111111111111
10000000S000001
100000010100001
100000010100001
100000010100001
100000010100001
100000010100001
100000010100001
100000010111111
100000010000001
111111111111111