NO ./textures/so.xpm
SO ./textures/no.xpm
EA ./textures/we.xpm
WE ./textures/ea.xpm

F 105,111,001
C 225,30,0
	  	 
111111       111   111
100101111    101    1
111000001    111
  1000111          1111
  11111     11111
         111100011111
         10000000N001
         111111111111
   