SO ./textures/so.xpm
NO ./textures/no.xpm
WE ./textures/we.xpm
EA ./textures/ea.xpm

F 220,100,0
C 225,30,0


1111111111
1000000001
10000S0001
1000000001
1011111001
1010001001
1010001001
1011111001
1000000001
1111111111