NO ./textures/so.xpm
SO ./textures/no.xpm
WE ./textures/ea.xpm
EA ./textures/we.xpm

F 105,111,001
C 225,30,0

111111111111111111111
100000000000000000001
100000000000000000001
100111111111111111001
100100000000000001001
100100000000000001001
100100111111111001001
100100100000001001001
100100100000001001001
100100111111111001001
100100000000000001001
100111111111111111001
100000000000000000001
111111111111111111111