SO ./textures/so.xpm
NO ./textures/no.xpm
WE ./textures/we.xpm
EA ./textures/ea.xpm

F 220,100,0
C 225,30,0

11111111111111111111
10000000000000000001
11111111000011111111
       100001
       100001
       100001
       100001
       100001
       1000W1
       111111