NO ./textures/so.xpm
SO ./textures/no.xpm
WE ./textures/ea.xpm
EA ./textures/we.xpm

F 105,111,001  
C 225,30,0		

111111
100101111
1110N0001
  100S111
  11111
   