NO ./textures/so.xpm
SO ./textures/no.xpm
EA ./textures/we.xpm
WE ./textures/ea.xpm

F 105,111,001
C 225,30,0

1111111
1  E  1
1     1
1111111