NO ./textures/so.xpm
SO ./textures/no.xpm
WE ./textures/ea.xpm
EA ./textures/we.xpm

F 105,111,001  
C 225,30,0


1111111
1000001
100N001
1000001
1000a01
1111111