NO ./textures/so.xpm
SO ./textures/no.xpm
EA ./textures/we.xpm
WE ./textures/ea.xpm

F 1,110,152
C 225,30,4

111111
101101
101001
1100E1
111111
