NO ./textures/so.xpm
SO ./textures/no.xpm
EA ./textures/we.xpm
WE ./textures/ea.xpm

F 220,100,0
C 225,30,0



111111
101101
101001
1100N1
111111