NO ./textures/so.xpm
SO ./textures/no.xpm
EA ./textures/we.xpm
WE ./textures/ea.xpm

F 105,111,001
C 225,30,0

111111
101101
101001
1100E1
111111
