

     N    O   ./  te xt   u  r e    s/     n o      .   x    p    m   
C  22 5, 30     ,0

WE ./t ext ures/ we.xp m  

   
  F  255,255,255
  
  
E   A ./textures/ea.xpm 
  
SO ./textures/so.xpm 
               11111111111111111111111
               11111111111111111111111
              1000000000110000000000001     
              1011000001110000000000001
              1001000000000000000000001
      111111110011000001110000000000001
      10000000001100000111011111111111
      11110111111111011100000010001
      11110111111111011101010010001
      11000011110101011100000010001
      100111    1100001100000010001
      1000001111000000110101001000111111
      11000001110101011111011110N0111001
      11110111 1110101 10111101000111111
      11111111 1111111 111111111111

      
