	 	 	 
F 2  20   ,100,   0
		 	 		 	        
N   O   ./path_to_the    _no  rt  h_te x  tu re

      SO ./   path_to_t   he_sou  th_te x   ture
	 		 
W  E ./p   at h_  to_   th   e   _wes   t_      ex  t   u re  
		 
	  


	 	 


		 	 
    

    
	 	 	 

C   2   2  5,3   0  ,0   
	 

EA ./path_   to_the_east_  textur   e     
	 


			     	    	   
111111
100101
101001
1100N1
111111
   