SO ./textures/so.xpm
NO ./textures/no.xpm
WE ./textures/we.xpm
EA ./textures/ea.xpm

F 220,100,0
C 225,30,0



       111
     1110111
   11100000111
 111000000000111
11000000000000011
10000000000000001
10000000S00000001
11000000000000011
 111000000000111
   11100000111
     1110111
       111