

	 	    	  	 	 
C    2     2       5  ,      3    0      ,0    
	 	 	  
		  
             S   O   . / t e x t u r es / s             o    .xpm   
	 	 	 
	 	 

F  22     0,1     00,0    

		  	 
	 	 	 
		 	 	 
 E                      A ./te      xtures/           ea        .xpm   

	 	 	 
	 	  

W             E ./t ex tu res/            we.xp          m     
	  	 	 	 


	 	 	  
	 	 	 

		 		 


	 	 

N   O                               ./  te x tur es /no .xp            m    
	  	 
		 		 
	 	 

111111       111   111
100101111    101    1
111000001    111
  100N111          1111
  11111     11111
         111100011111
         100000000001
         111111111111
   