11111111111111111111
10000000000000000001
11111111000011111111
       100001
	   100001
	   100001
	   100001
	   100001
	   100001
	   111111