111111111
10000000001
1000001
10000000