fefre
reer
111111111
100000001
10000000111111
     100000001
11111111111111
111111111
111111111
111111111
100000001
