11111111111111
10000000000001
10000000111001
10000011111001
11111111111111